1 1 1 1 1 1 1 1 1 1 1 1 1 1 1 1 1 1 1 1 1 1 1 1 1 1 1 1 1 1 1 1 1 1 1 1 1 1 1 1 1 1 1 1 1 1 1 1 1 1 
1 1 1 1 1 1 1 1 1 1 1 1 1 1 1 1 1 1 1 1 1 1 1 1 1 1 1 1 1 1 1 1 1 1 1 1 1 1 1 1 1 1 1 1 1 1 1 1 1 1 
1 1 1 1 1 1 1 1 1 1 1 1 1 1 1 1 1 1 1 1 1 1 1 1 1 1 1 1 1 1 1 1 1 1 1 1 1 1 1 1 1 1 1 1 1 1 1 1 1 1 
1 1 1 1 1 1 1 1 1 1 1 1 1 1 1 1 1 1 1 1 1 1 1 1 1 1 1 1 1 1 1 1 1 1 1 1 1 1 1 1 1 1 1 1 1 1 1 1 1 1 
1 1 1 1 1 1 1 1 1 1 1 1 1 1 1 1 1 1 1 1 1 1 1 1 1 1 1 1 1 1 1 1 1 1 1 1 1 1 1 1 1 1 1 1 1 1 1 1 1 1 
1 1 1 1 1 1 1 1 1 1 1 1 1 1 1 1 1 1 1 1 1 1 1 1 1 1 1 1 1 1 1 1 1 1 1 1 1 1 1 1 1 1 1 1 1 1 1 1 1 1 
1 1 1 18 7 7 7 7 7 7 7 7 7 7 7 7 7 7 7 7 7 7 7 7 7 7 7 7 7 7 7 7 7 7 7 7 7 7 7 7 7 7 7 7 7 7 17 1 1 1 
1 1 1 9 0 0 0 0 0 0 0 0 0 0 0 0 0 0 0 0 0 0 0 0 0 0 0 0 0 0 0 0 0 0 0 0 0 0 0 0 0 0 0 0 0 0 8 1 1 1 
1 1 1 9 0 0 0 0 0 0 0 0 0 0 0 0 0 0 0 0 0 0 0 0 0 0 0 0 0 0 0 0 0 0 0 0 0 0 4 4 4 0 0 0 0 0 8 1 1 1 
1 1 1 9 0 0 0 0 0 0 0 0 0 0 0 0 0 4 4 0 0 0 0 0 0 0 0 0 0 0 0 0 0 0 0 0 0 0 4 4 0 0 0 0 0 0 8 1 1 1 
1 1 1 9 0 0 0 14 0 0 0 0 0 0 0 14 4 4 4 4 0 0 0 0 0 0 0 0 0 14 14 0 0 0 0 0 0 0 0 0 0 0 0 0 0 0 8 1 1 1 
1 1 1 9 0 0 0 4 0 0 0 0 0 0 0 0 4 4 4 4 0 0 0 0 0 0 0 0 0 14 0 0 0 0 0 0 0 0 0 0 14 14 0 0 0 0 8 1 1 1 
1 1 1 9 0 0 0 0 0 0 0 0 0 0 14 0 4 4 4 0 0 0 0 0 0 0 0 0 0 0 0 0 0 0 0 0 0 0 0 0 0 0 0 0 0 0 8 1 1 1 
1 1 1 9 0 0 0 0 0 0 0 0 0 0 14 0 0 4 4 0 0 0 0 0 0 0 0 0 0 0 0 0 0 10 6 6 6 12 0 0 0 0 0 0 0 0 8 1 1 1 
1 1 1 9 0 0 0 0 0 0 0 0 0 14 14 0 0 0 0 0 0 0 0 0 0 0 0 0 0 0 0 0 10 15 1 1 1 16 12 0 0 0 0 0 0 0 8 1 1 1 
1 1 1 9 0 0 0 0 0 0 0 0 4 14 0 0 0 0 0 0 0 0 0 0 0 0 0 0 0 0 0 0 11 1 1 1 1 1 9 0 0 0 0 0 0 0 8 1 1 1 
1 1 1 9 0 0 0 0 14 0 0 0 4 14 0 0 0 0 0 0 0 0 0 0 0 0 0 0 0 0 0 0 0 11 1 1 1 1 9 0 0 0 0 0 0 0 8 1 1 1 
1 1 1 9 0 0 0 0 14 0 0 0 0 0 0 0 0 0 0 0 0 0 14 0 0 0 0 0 14 0 0 0 0 0 11 7 7 1 16 12 0 0 0 4 0 0 8 1 1 1 
1 1 1 9 0 0 0 0 0 0 0 0 0 0 0 0 0 0 0 0 0 0 14 0 0 0 4 0 0 0 0 0 0 0 0 0 0 11 7 13 0 0 0 0 0 0 8 1 1 1 
1 1 1 9 0 0 0 0 0 0 0 0 0 0 0 0 0 0 0 0 0 0 0 0 0 4 4 4 0 0 0 14 0 0 0 0 0 0 0 0 0 0 0 0 0 0 8 1 1 1 
1 1 1 9 0 0 0 0 0 0 0 0 0 0 4 0 0 0 0 0 0 0 0 0 4 4 4 4 4 0 0 14 0 0 0 0 0 0 0 0 0 0 0 0 0 0 8 1 1 1 
1 1 1 9 0 0 0 0 0 0 0 0 0 0 0 0 0 0 0 0 0 0 0 0 0 4 4 4 0 0 0 0 0 0 0 0 0 0 0 0 0 0 0 0 0 0 8 1 1 1 
1 1 1 9 0 0 0 0 0 0 0 0 0 0 0 0 0 0 0 14 0 0 0 0 0 0 4 0 0 0 0 0 0 0 14 0 0 0 0 0 0 0 0 0 0 0 8 1 1 1 
1 1 1 9 0 0 0 0 0 0 0 0 0 0 0 0 0 0 0 0 0 0 0 0 0 0 0 0 0 0 0 0 0 0 14 0 0 0 0 0 0 0 0 0 0 0 8 1 1 1 
1 1 1 9 0 0 0 0 0 0 0 0 0 0 0 0 0 0 0 0 0 0 0 0 0 0 0 0 0 0 0 0 0 0 0 0 0 0 0 0 0 0 0 0 0 0 8 1 1 1 
1 1 1 9 0 0 0 14 0 0 0 0 0 0 0 0 0 0 0 0 0 0 0 0 0 0 0 0 0 0 0 0 0 0 0 0 0 0 0 0 0 0 4 0 0 0 8 1 1 1 
1 1 1 9 0 0 0 0 0 0 0 0 0 0 0 0 0 0 0 0 0 0 0 0 0 0 0 0 0 0 0 0 0 0 0 0 0 0 0 0 0 0 0 0 0 0 8 1 1 1 
1 1 1 9 0 0 0 0 0 4 0 0 14 0 0 0 0 4 4 4 4 4 0 0 0 0 0 0 0 0 0 0 0 0 0 0 0 0 0 0 0 0 0 0 0 0 8 1 1 1 
1 1 1 9 0 0 0 0 0 0 0 0 0 0 0 0 0 4 0 0 0 0 14 4 4 4 4 4 4 4 4 4 4 4 4 0 0 0 0 0 0 14 0 0 0 0 8 1 1 1 
1 1 1 9 0 0 0 0 0 0 0 0 0 0 0 0 0 4 0 4 0 0 14 0 0 0 0 0 0 14 0 0 0 0 4 4 0 0 0 0 0 0 0 0 0 0 8 1 1 1 
1 1 1 9 0 0 0 0 0 0 0 0 0 0 0 0 4 4 0 0 0 0 0 0 0 4 0 0 0 0 0 0 0 0 0 4 0 0 0 0 0 0 0 0 0 0 8 1 1 1 
1 1 1 9 0 0 0 0 14 0 0 0 0 0 0 0 4 0 0 0 4 0 0 4 4 4 14 0 0 0 0 4 0 0 14 4 4 0 0 0 0 0 4 0 0 0 8 1 1 1 
1 1 1 9 0 0 0 0 4 0 0 0 0 0 0 0 4 0 14 0 4 0 0 0 0 0 0 0 0 0 0 0 0 0 0 0 4 0 14 0 0 0 0 0 0 0 8 1 1 1 
1 1 1 9 0 0 0 0 14 0 0 0 0 0 0 0 14 0 14 0 0 0 0 2 2 2 2 2 2 2 2 0 0 0 4 0 14 0 0 0 0 0 0 0 0 14 8 1 1 1 
1 1 1 9 0 0 14 0 14 0 0 0 14 0 0 0 4 0 0 0 0 0 0 2 3 3 3 3 3 3 2 0 14 0 0 0 4 0 0 0 0 0 0 0 0 0 8 1 1 1 
1 1 1 9 0 0 0 4 4 4 0 0 14 0 0 0 4 0 0 14 4 0 0 2 3 3 3 3 3 3 2 0 14 0 0 0 4 0 0 0 0 0 0 0 0 0 8 1 1 1 
1 1 1 9 0 0 0 4 4 4 0 0 0 0 0 0 14 0 0 14 0 0 0 2 3 3 3 3 3 3 2 0 0 0 4 4 4 0 0 0 0 0 0 0 0 0 8 1 1 1 
1 1 1 9 0 0 0 0 4 0 0 0 0 0 0 4 4 0 0 0 0 0 0 2 3 3 3 3 3 3 2 0 0 0 0 4 4 0 0 0 0 14 0 0 0 0 8 1 1 1 
1 1 1 9 0 0 0 0 0 0 0 0 0 0 4 4 0 0 4 0 0 0 0 2 3 3 3 3 3 3 2 0 0 0 0 0 14 0 0 0 0 0 0 4 0 0 8 1 1 1 
1 1 1 9 0 0 0 14 0 0 0 0 0 0 4 0 0 4 0 14 0 0 4 2 2 2 3 2 2 2 2 0 0 14 0 0 4 0 0 0 0 0 0 0 0 0 8 1 1 1 
1 1 1 9 0 0 0 0 0 0 0 0 0 0 4 4 0 0 0 0 0 0 0 0 0 0 0 0 0 0 0 0 0 0 0 4 4 0 0 0 0 0 0 0 0 0 8 1 1 1 
1 1 1 9 0 0 0 0 0 0 0 0 0 0 4 4 4 0 0 0 0 0 0 14 0 0 0 0 0 0 0 0 0 4 4 4 0 0 0 14 0 0 0 14 0 0 8 1 1 1 
1 1 1 9 0 0 0 0 0 0 0 14 0 0 4 0 14 0 0 0 0 4 0 0 0 14 0 0 0 14 14 0 0 0 0 4 0 0 0 0 0 0 0 14 0 0 8 1 1 1 
1 1 1 9 0 0 14 0 0 0 0 0 0 0 4 14 4 0 0 0 0 0 0 0 14 0 0 0 0 0 0 14 0 0 0 4 0 0 0 0 0 0 0 0 0 0 8 1 1 1 
1 1 1 9 0 0 0 0 0 0 0 0 0 0 0 0 4 4 4 4 4 4 0 0 0 0 0 0 4 0 0 0 0 4 4 0 0 0 0 14 0 0 0 0 0 0 8 1 1 1 
1 1 1 9 0 0 0 0 0 0 0 0 0 0 0 0 0 0 0 0 0 4 4 4 14 4 0 0 0 0 0 0 14 4 4 0 0 0 0 0 0 0 0 0 0 0 8 1 1 1 
1 1 1 9 0 0 0 0 0 0 0 0 0 0 0 0 0 0 0 0 0 0 0 0 0 0 4 4 4 14 4 4 0 0 0 0 0 0 0 0 0 0 0 14 0 0 8 1 1 1 
1 1 1 9 0 0 14 0 0 0 0 0 0 0 0 0 0 0 0 0 0 0 0 0 0 0 0 0 0 0 0 0 0 0 0 0 0 0 0 0 0 0 0 0 0 0 8 1 1 1 
1 1 1 9 0 0 0 0 0 0 0 0 0 0 0 0 0 0 0 0 0 0 0 0 0 0 0 0 0 0 0 0 0 0 0 0 0 0 0 0 0 0 0 0 0 0 8 1 1 1 
1 1 1 9 0 0 0 0 0 0 0 0 0 0 0 0 0 0 0 0 0 0 0 0 0 0 0 0 0 0 0 0 0 0 0 0 0 0 0 0 0 0 0 0 0 0 8 1 1 1 
