4 4 4 11 7 13 4 8 1 1 1 1 1 9 0 0 0 0 0 0 0 0 4 0 4 0 4 0 4 4 4 4 4 4 4 4 4 4 4 4 4 4 4 4 4 4 4 4 4 4
4 4 4 0 0 0 4 8 1 1 1 1 1 9 0 0 0 0 0 0 0 0 4 4 4 4 4 0 4 4 4 4 4 4 4 4 4 4 4 4 4 4 4 4 4 4 4 4 4 4
4 4 4 14 0 0 4 11 1 1 1 1 1 16 12 0 10 12 0 0 0 0 4 4 4 4 4 0 4 4 4 4 4 4 4 4 4 0 12 4 4 4 4 4 4 4 4 4 4 4
4 4 4 0 0 0 4 5 11 7 1 1 1 1 16 6 15 16 12 0 0 0 4 4 4 4 4 4 4 4 4 4 4 4 10 6 6 6 13 4 4 4 4 4 4 4 4 4 4 4
4 4 4 0 0 0 14 0 5 5 11 1 1 1 1 1 1 1 16 12 5 0 4 4 5 10 6 6 12 4 4 4 4 0 0 0 11 13 0 0 0 0 0 0 0 0 0 0 4 4
4 4 4 0 0 0 0 0 5 5 5 11 1 1 1 1 1 1 1 16 12 5 4 4 10 0 0 0 0 0 4 4 4 0 0 0 0 0 0 4 4 4 4 4 0 0 0 0 0 4
4 4 4 0 14 0 0 0 0 0 5 4 8 1 1 1 1 1 1 1 16 12 5 4 11 0 10 6 12 0 0 0 0 0 0 0 0 0 0 4 4 4 4 4 0 0 0 0 0 4
4 4 4 0 0 0 0 0 0 0 4 4 8 1 1 1 1 1 1 1 9 5 5 4 3 0 11 7 7 13 4 0 4 0 0 0 0 0 0 4 4 4 4 4 4 4 0 0 4 4
4 4 4 4 0 0 0 14 0 0 0 4 11 1 1 1 1 1 1 1 16 12 0 4 4 4 4 4 4 4 4 4 0 0 0 0 0 0 0 4 4 4 4 4 4 4 0 0 4 4
4 4 4 4 0 0 0 0 0 0 0 0 4 11 7 7 7 1 1 1 1 16 12 0 4 4 0 10 6 6 6 12 4 0 0 0 0 0 0 0 0 0 0 0 4 4 0 0 4 4
4 4 4 4 0 0 0 0 0 0 0 0 0 5 5 5 5 11 7 1 1 1 16 6 6 6 6 15 1 1 1 16 6 12 0 0 0 0 0 0 0 0 0 0 4 4 0 0 4 4
4 4 4 4 0 0 0 0 0 0 0 0 0 0 5 5 5 5 5 8 1 1 1 1 1 1 1 1 1 1 1 1 1 16 6 6 12 0 0 0 0 0 0 0 4 4 0 0 4 4
4 4 4 4 0 0 0 0 0 0 0 14 0 4 0 0 5 5 5 11 1 1 1 1 1 1 1 1 1 7 1 1 1 1 1 1 16 12 0 0 0 0 0 0 4 4 0 0 4 4
4 4 4 4 0 0 0 14 0 0 0 0 0 4 4 0 4 5 5 5 11 7 1 1 1 1 1 7 13 0 8 1 1 1 1 7 13 0 0 0 0 0 0 0 4 4 0 0 4 4
4 4 4 4 0 0 0 0 0 0 0 0 0 0 4 4 4 4 5 5 5 3 11 7 1 1 9 0 0 0 11 7 1 1 9 0 0 0 0 0 0 0 0 0 4 4 0 0 4 4
4 0 0 4 0 0 0 0 0 0 14 0 0 0 0 0 0 4 4 0 4 5 3 14 8 1 9 0 14 0 0 0 11 1 13 0 0 0 0 0 0 0 0 0 4 4 0 0 4 4
4 0 0 0 0 0 0 0 0 0 0 0 0 0 0 0 0 0 0 0 3 3 3 0 8 1 9 5 0 0 0 14 0 7 0 0 0 0 0 0 0 0 0 0 4 4 0 0 4 4
4 0 0 0 0 0 0 0 0 0 0 0 0 0 0 0 0 0 0 0 0 3 3 0 8 0 9 5 0 0 4 4 4 4 4 4 4 4 4 4 4 4 4 4 4 4 0 0 4 4
4 0 0 0 0 0 0 0 0 0 0 0 0 0 0 0 0 0 0 0 0 0 0 0 8 6 9 5 0 4 4 4 4 4 4 4 4 4 4 4 4 4 4 4 4 4 0 0 4 4
4 0 0 0 0 0 0 0 0 0 0 0 0 0 0 14 0 0 0 0 0 0 0 0 8 1 9 5 4 4 4 4 4 4 4 4 4 4 4 4 4 4 4 4 4 4 0 0 4 4
4 0 0 0 0 0 0 0 0 0 0 0 0 0 0 0 0 0 0 0 0 0 0 0 8 1 9 5 4 4 4 0 0 0 0 0 0 0 0 0 0 0 0 0 4 4 0 0 4 4
4 0 0 0 0 0 0 0 0 0 0 0 0 0 0 0 0 0 0 14 0 0 0 10 15 1 13 5 4 4 4 0 0 2 2 2 2 2 2 2 2 2 0 0 4 4 4 0 4 10
4 0 0 0 0 0 0 0 0 0 0 0 14 0 0 0 0 0 0 0 0 0 10 15 1 9 5 5 4 4 4 0 0 2 3 3 3 3 3 3 3 2 0 0 4 4 4 0 4 8
4 0 0 0 0 0 0 0 0 0 0 0 0 0 0 0 0 0 0 0 0 0 8 1 1 13 5 5 4 4 4 0 0 2 3 3 3 3 3 3 3 2 0 0 4 4 4 0 0 8
4 0 0 0 0 0 0 0 0 0 0 0 0 0 0 0 0 0 0 0 0 0 8 1 9 5 5 0 4 4 4 0 0 2 3 3 3 3 3 3 3 2 0 0 4 4 4 0 0 8
4 0 0 0 0 0 0 0 0 0 0 0 0 0 0 0 0 0 0 0 0 0 8 1 9 5 5 0 4 4 4 0 0 2 3 3 3 3 3 3 3 2 0 0 4 4 4 0 0 8
4 0 0 0 0 0 0 0 0 0 0 0 0 0 0 0 0 10 6 6 6 6 15 1 9 5 0 0 4 4 4 0 0 2 3 3 3 3 3 3 3 2 0 0 4 4 4 0 0 8
4 0 0 0 0 0 0 0 0 0 0 0 0 0 0 0 10 15 1 1 1 1 1 1 9 5 0 0 0 4 4 0 0 2 2 2 2 3 2 2 2 2 0 0 4 4 0 0 0 8
4 0 0 0 0 0 0 0 0 0 0 0 0 0 0 0 8 1 1 1 1 1 1 1 9 0 0 14 0 0 4 0 0 0 14 14 0 0 0 0 14 0 0 0 4 0 0 0 0 8
4 0 0 0 0 0 0 0 0 0 0 0 0 0 0 0 8 1 1 1 1 1 1 1 13 0 0 0 0 0 4 0 0 0 0 0 0 0 0 0 0 0 0 0 4 0 0 0 0 8
4 0 0 0 0 0 0 0 0 0 0 0 0 0 0 0 8 1 1 1 1 1 1 13 0 0 0 0 0 0 0 0 0 0 0 0 0 0 0 0 0 0 0 0 0 0 0 0 0 8
4 0 0 0 0 0 0 0 0 0 0 0 0 0 0 0 11 1 1 1 1 1 13 0 0 0 0 0 0 0 14 0 0 0 0 14 0 0 0 0 0 0 0 0 0 14 0 0 0 8
4 0 0 0 0 0 0 0 0 0 0 0 0 0 0 0 0 11 1 1 1 13 0 0 0 0 14 0 0 0 0 0 0 0 0 0 0 0 0 0 0 0 0 0 0 0 0 0 0 8
4 0 0 0 0 0 0 0 0 0 0 0 0 0 0 0 0 0 11 7 13 0 0 0 0 0 0 0 0 0 0 0 0 0 0 0 0 0 0 0 0 0 0 0 0 0 0 0 0 8
4 0 0 0 0 0 0 0 0 0 14 0 0 0 0 0 0 0 0 0 0 0 0 0 0 0 0 0 0 14 0 0 0 0 0 0 0 0 0 0 0 0 0 0 0 0 0 0 0 8
4 0 0 0 0 0 0 0 0 0 0 0 0 0 0 0 0 0 0 0 0 0 0 0 0 14 0 0 0 0 3 0 0 0 0 0 0 0 0 0 0 0 0 0 0 0 0 0 0 8
4 0 0 0 0 0 14 0 14 0 0 0 0 0 0 0 0 0 0 0 0 0 14 0 0 0 0 0 0 0 3 0 0 0 0 0 0 14 0 0 0 0 0 0 0 0 0 0 0 8
4 0 0 0 0 0 0 14 0 0 0 0 0 0 0 0 0 0 0 0 0 0 0 0 0 0 0 0 0 3 3 3 0 0 0 3 0 0 0 0 0 0 0 4 4 0 0 0 0 8
4 0 0 0 0 0 0 0 0 0 0 0 0 0 0 0 0 0 14 0 0 0 0 0 0 0 0 0 0 3 3 3 3 3 3 3 0 0 0 0 0 0 0 4 4 0 0 0 0 8
4 0 0 0 0 0 0 0 0 0 0 0 14 0 0 0 0 0 0 0 0 0 0 0 0 0 0 0 0 3 3 3 3 3 3 3 3 0 0 0 0 0 0 0 4 0 0 0 0 8
4 0 0 0 0 0 0 0 14 0 0 0 0 0 0 0 0 0 0 0 0 0 0 0 0 0 0 0 0 3 3 3 4 3 3 3 3 0 0 0 0 0 0 0 0 0 0 0 0 8
4 0 0 0 0 0 0 0 0 0 0 0 0 0 0 0 0 0 0 0 0 0 0 0 0 0 0 0 0 3 3 3 3 3 3 3 3 0 0 0 0 0 0 14 0 0 0 0 10 1
4 0 0 0 0 0 0 0 0 0 0 14 0 0 0 0 0 0 0 0 0 0 0 0 0 0 0 4 4 4 4 4 4 0 4 4 4 4 4 0 0 0 0 0 0 0 0 10 1 1
4 0 0 0 0 14 0 0 0 0 0 0 0 0 0 0 0 0 0 0 0 0 14 0 0 0 0 4 4 4 4 4 0 0 4 4 4 4 4 10 14 0 0 0 0 0 10 1 1 1
4 0 0 0 0 0 0 0 0 0 0 0 0 0 0 0 0 0 0 0 0 0 0 0 0 0 0 4 4 4 0 0 0 4 4 4 4 4 4 8 12 14 0 0 0 14 8 1 1 7
4 0 0 0 0 0 0 10 6 6 6 6 12 0 0 0 0 0 0 0 0 0 4 0 0 0 0 4 4 4 0 4 4 4 0 0 0 4 4 11 7 12 14 0 0 10 1 1 9 0
4 0 0 0 0 0 10 1 1 1 1 1 1 12 0 0 0 0 0 0 0 0 0 0 0 0 0 4 4 4 0 4 4 4 0 4 0 4 4 4 4 4 10 0 14 8 7 7 13 0
4 0 0 0 0 0 11 1 1 1 1 1 1 13 0 0 0 0 0 0 0 0 0 0 0 0 0 4 4 4 0 0 0 4 0 4 0 4 0 0 3 4 8 6 6 9 0 0 0 0
4 0 0 0 0 0 0 11 7 7 7 7 13 0 0 0 0 0 0 0 0 0 0 0 0 0 0 4 4 4 4 4 0 0 0 4 0 0 0 0 1 4 8 1 1 13 0 0 0 0
4 4 4 4 4 4 4 4 4 4 4 4 4 4 4 4 4 4 4 4 4 4 4 4 4 4 4 4 4 4 4 4 4 4 4 4 4 4 4 4 4 4 8 1 9 0 0 0 0 0