1 1 1 1 1 1 1 1 1 1 1 1 1 1 1 1 1 1 1 1 1 1 1 1 1 1 1 1 1 1 1 1 1 1 1 1 1 1 1 1 1 1 1 1 1 1 1 1 1 1 
1 1 1 1 1 1 1 1 1 1 1 1 1 1 1 1 1 1 1 1 1 1 1 1 1 1 1 1 1 1 1 1 1 1 1 1 1 1 1 1 1 1 1 1 1 1 1 1 1 1 
1 1 1 1 1 1 1 1 1 1 1 1 1 1 1 1 1 1 1 1 1 1 1 1 1 1 1 1 1 1 1 1 1 1 1 1 1 1 1 1 1 1 1 1 1 1 1 1 1 1 
1 1 1 1 1 1 1 1 1 1 1 1 1 1 1 1 1 1 1 1 1 1 1 1 1 1 1 1 1 1 1 1 1 1 1 1 1 1 1 1 1 1 1 1 1 1 1 1 1 1 
1 1 1 1 1 1 1 1 1 1 1 1 1 1 1 1 1 1 1 1 1 1 1 1 1 1 1 1 1 1 1 1 1 1 1 1 1 1 1 1 1 1 1 1 1 1 1 1 1 1 
1 1 1 1 1 1 1 1 1 1 1 1 1 1 1 1 1 1 1 1 1 1 1 1 1 1 1 1 1 1 1 1 1 1 1 1 1 1 1 1 1 1 1 1 1 1 1 1 1 1 
1 1 1 18 7 7 7 7 7 7 7 7 7 7 7 7 7 7 7 7 7 7 7 7 7 7 7 7 7 7 7 7 7 7 7 7 7 7 7 7 7 7 7 7 7 7 17 1 1 1 
1 1 1 9 0 0 0 0 0 0 0 0 0 0 0 0 0 0 0 0 0 0 0 0 0 0 0 0 0 0 0 0 0 0 0 14 0 0 0 0 0 0 0 0 0 0 8 1 1 1 
1 1 1 9 0 0 0 0 0 0 14 0 0 0 0 0 0 14 0 0 0 0 0 14 0 0 0 0 0 0 0 0 0 0 0 0 0 0 0 0 0 0 0 0 0 0 8 1 1 1 
1 1 1 9 0 0 14 0 0 0 0 0 0 0 0 14 0 0 0 0 0 0 0 0 0 0 0 0 0 0 14 0 0 0 0 0 0 0 0 0 0 14 0 0 0 0 8 1 1 1 
1 1 1 9 0 0 0 4 4 4 0 0 4 4 4 4 4 4 4 4 4 4 0 0 5 5 5 0 0 4 4 4 4 4 0 4 4 4 4 4 4 4 4 0 0 0 8 1 1 1 
1 1 1 9 0 0 0 4 4 4 0 0 4 4 4 4 4 4 4 4 4 4 0 0 5 5 5 0 0 4 4 4 4 4 0 4 4 4 4 4 4 4 4 0 0 0 8 1 1 1 
1 1 1 9 0 0 0 4 4 2 3 3 2 2 2 2 2 2 2 2 4 4 0 0 5 5 5 0 0 4 4 4 4 4 14 4 4 4 4 4 4 4 4 14 0 0 8 1 1 1 
1 1 1 9 0 0 0 4 4 2 3 3 3 3 3 3 3 3 3 2 4 4 0 0 5 5 5 0 0 4 4 4 4 4 0 0 14 0 0 14 0 4 4 0 0 0 8 1 1 1 
1 1 1 9 0 0 0 4 4 2 2 2 2 2 2 3 3 3 3 2 4 4 0 0 5 5 5 0 0 4 4 4 4 4 4 4 4 4 4 4 0 4 4 0 0 0 8 1 1 1 
1 1 1 9 0 0 0 4 4 2 3 3 3 3 3 3 3 3 3 2 4 4 0 0 5 5 5 0 0 4 4 4 4 4 4 4 4 4 4 4 14 4 4 0 0 0 8 1 1 1 
1 1 1 9 0 14 0 4 4 2 3 3 3 2 2 2 2 2 2 2 4 4 0 14 5 5 5 0 0 4 4 4 4 4 4 4 4 4 4 4 0 4 4 0 14 0 8 1 1 1 
1 1 1 9 0 0 0 4 4 2 3 3 3 3 3 3 3 2 3 2 4 4 0 0 5 5 5 0 0 4 4 0 0 0 0 0 14 0 0 0 0 4 4 0 0 0 8 1 1 1 
1 1 1 9 0 0 0 4 4 2 3 3 3 3 2 3 3 2 3 2 4 4 14 0 5 5 5 0 0 4 4 14 4 4 4 4 4 4 4 4 4 4 4 0 0 0 8 1 1 1 
1 1 1 9 0 0 0 4 4 2 3 3 3 3 2 3 3 3 3 2 4 4 0 0 5 5 5 0 0 4 4 0 0 14 0 0 0 4 4 4 4 4 4 0 0 0 8 1 1 1 
1 1 1 9 0 0 0 4 4 2 2 2 2 2 2 2 2 2 2 2 4 4 0 0 5 5 5 0 0 4 4 4 4 4 4 4 2 4 4 4 4 4 4 0 0 0 8 1 1 1 
1 1 1 9 0 14 0 4 4 4 4 4 4 4 4 4 4 4 4 4 4 4 0 0 5 5 5 0 0 4 4 4 4 4 4 4 4 4 4 4 4 4 4 0 0 0 8 1 1 1 
1 1 1 9 0 0 0 4 4 4 4 4 4 4 4 4 4 4 4 4 4 4 0 0 5 5 5 0 0 4 4 14 4 4 4 4 4 4 4 4 4 4 4 0 0 0 8 1 1 1 
1 1 1 9 0 0 0 0 0 0 0 0 0 0 0 0 0 0 0 0 0 0 0 0 5 5 5 0 0 0 0 0 0 0 0 0 0 0 0 0 0 0 0 0 0 0 8 1 1 1 
1 1 1 9 0 0 0 5 5 5 5 5 5 5 5 5 5 5 5 5 5 5 5 5 5 5 5 5 5 5 5 5 5 5 5 5 5 5 5 5 5 5 5 0 0 0 8 1 1 1 
1 1 1 9 0 0 0 5 5 5 5 5 5 5 5 5 5 5 5 5 5 5 5 5 5 5 5 5 5 5 5 5 5 5 5 5 5 5 5 5 5 5 5 14 0 0 8 1 1 1 
1 1 1 9 0 0 0 0 0 0 0 0 0 0 0 0 0 14 0 0 0 0 0 0 5 5 5 0 0 0 0 0 0 0 0 0 0 0 0 14 0 0 0 0 0 0 8 1 1 1 
1 1 1 9 0 0 14 4 4 4 4 4 4 4 4 4 4 4 4 4 4 4 0 0 5 5 5 0 0 4 4 4 4 4 4 4 4 4 4 4 4 4 4 0 14 0 8 1 1 1 
1 1 1 9 0 0 0 4 4 4 4 4 4 4 4 4 4 4 4 4 4 4 0 0 5 5 5 0 0 4 4 4 4 4 4 4 4 4 4 4 4 4 4 0 0 0 8 1 1 1 
1 1 1 9 0 0 0 4 4 4 4 4 4 4 4 4 4 4 4 4 4 4 0 0 5 5 5 0 0 4 4 4 4 4 4 4 4 4 4 4 4 4 4 0 0 0 8 1 1 1 
1 1 1 9 0 0 0 4 4 4 4 4 4 4 4 4 4 4 4 4 4 4 14 0 5 5 5 0 0 4 4 4 4 4 4 0 0 0 0 4 4 4 4 0 0 0 8 1 1 1 
1 1 1 9 0 0 0 4 4 0 0 0 0 0 14 0 0 0 4 0 4 4 0 0 5 5 5 0 14 4 4 4 4 4 0 0 10 12 0 0 4 4 4 0 0 0 8 1 1 1 
1 1 1 9 0 0 0 4 4 0 4 0 0 0 0 0 0 0 0 0 4 4 0 0 5 5 5 0 0 4 4 4 4 4 0 10 15 16 12 0 4 4 4 0 0 0 8 1 1 1 
1 1 1 9 0 0 0 4 4 14 0 0 2 2 2 2 2 0 0 0 4 4 0 0 5 5 5 0 0 4 4 0 0 0 0 8 1 1 9 0 4 4 4 0 14 0 8 1 1 1 
1 1 1 9 0 0 0 4 4 0 0 0 2 3 3 3 2 0 0 0 4 4 0 0 5 5 5 0 0 4 4 0 4 4 0 11 17 18 13 0 4 4 4 0 0 0 8 1 1 1 
1 1 1 9 0 0 0 4 4 4 0 0 2 3 3 3 2 0 14 0 4 4 0 0 5 5 5 0 0 4 4 0 4 4 0 0 11 13 0 4 4 4 4 0 0 0 8 1 1 1 
1 1 1 9 0 0 0 4 4 0 0 0 2 2 3 2 2 0 0 4 4 4 0 0 5 5 5 0 0 0 0 0 4 4 4 0 0 0 0 4 4 4 4 0 0 14 8 1 1 1 
1 1 1 9 0 14 0 4 4 0 14 0 0 0 0 0 0 0 0 0 4 4 0 0 5 5 5 14 0 4 4 4 4 4 4 4 4 4 4 4 4 4 4 0 0 0 8 1 1 1 
1 1 1 9 0 0 0 4 4 0 0 0 0 0 0 0 0 0 14 0 4 4 0 0 5 5 5 0 0 4 4 4 4 4 4 4 4 4 4 4 4 4 4 0 0 0 8 1 1 1 
1 1 1 9 0 0 0 4 4 4 4 4 4 4 0 4 4 4 4 4 4 4 0 14 5 5 5 0 0 4 4 4 4 4 4 4 4 4 4 4 4 4 4 0 0 0 8 1 1 1 
1 1 1 9 0 0 0 4 4 4 4 4 4 0 0 4 4 4 4 4 4 4 0 0 5 5 5 0 0 4 4 4 4 4 4 4 4 4 4 4 4 4 4 0 0 0 8 1 1 1 
1 1 1 9 0 0 0 4 4 4 4 4 4 0 4 4 4 4 4 4 4 4 14 0 5 5 5 0 0 4 4 4 4 4 4 4 4 4 4 4 4 4 4 14 0 0 8 1 1 1 
1 1 1 9 0 0 14 0 0 0 0 0 0 0 0 0 0 0 0 0 0 0 0 0 0 0 14 0 0 0 0 0 0 0 0 0 0 0 0 0 0 0 0 0 0 0 8 1 1 1 
1 1 1 9 0 0 0 0 0 0 0 0 0 0 0 0 0 0 0 0 0 0 0 0 0 0 0 0 0 0 0 0 0 14 0 0 0 0 0 0 0 0 0 0 14 0 8 1 1 1 
1 1 1 9 0 0 0 0 0 14 0 0 0 0 0 0 14 0 0 0 0 0 0 0 0 14 0 0 0 0 0 0 0 0 0 0 0 0 14 0 0 0 0 0 0 0 8 1 1 1 
1 1 1 16 6 6 6 6 6 6 6 6 6 6 6 6 6 6 6 6 6 6 6 6 6 6 6 6 6 6 6 6 6 6 6 6 6 6 6 6 6 6 6 6 6 6 15 1 1 1 
1 1 1 1 1 1 1 1 1 1 1 1 1 1 1 1 1 1 1 1 1 1 1 1 1 1 1 1 1 1 1 1 1 1 1 1 1 1 1 1 1 1 1 1 1 1 1 1 1 1 
1 1 1 1 1 1 1 1 1 1 1 1 1 1 1 1 1 1 1 1 1 1 1 1 1 1 1 1 1 1 1 1 1 1 1 1 1 1 1 1 1 1 1 1 1 1 1 1 1 1 
1 1 1 1 1 1 1 1 1 1 1 1 1 1 1 1 1 1 1 1 1 1 1 1 1 1 1 1 1 1 1 1 1 1 1 1 1 1 1 1 1 1 1 1 1 1 1 1 1 1 
1 1 1 1 1 1 1 1 1 1 1 1 1 1 1 1 1 1 1 1 1 1 1 1 1 1 1 1 1 1 1 1 1 1 1 1 1 1 1 1 1 1 1 1 1 1 1 1 1 1 
